# Tutorials
TutorialToAttack = "para atacar", # As in "Press X to attack"
Hold = "Presiona", # As in "Hold B to run"
Use = "Usa", # As in "Use left stick to move"
TutorialToMove = "para moverse",
TutorialToSprint = "para correr",
TutorialInventory = "para abrir el inventario y equipar tu espada",
TutorialDodge = "Eres [color=#ff4c42]invencible[/color] mientras esquivas.\n\nESQUIVA:",
TutorialDodge2 = "[color=#ff4c42]Esquiva ataques[/color] para evitar daño.\n\nESQUIVA:",
TutorialRest = "Descansa en una [color=#77FFFF]FUENTE[/color] para restaurar tu vida y guardar tu progreso.",
HealTutorial1 = "Ataca enemigos para cosechar [color=#77FFFF]AGUA[/color] ",
HealTutorial2 = "para curarte usando [color=#77FFFF]AGUA[/color]",
HealTutorial3 = "Mantén para curarte usando [color=#77FFFF]AGUA[/color]",
TutorialInventory2 = "Para usar consumibles, abre tu inventario:",
MapTutorial = "Abre el mapa:",
ToolEquipTutorial = "Para equipar esta nueva herramienta, abre tu inventario:",
ToolControllerTutorial1 = "Mantén para apuntar esta nueva herramienta:",
ToolControllerTutorial2 = "Suelta para disparar",
ToolKeyboardTutorial = "Presiona para disparar esta nueva herramienta:",

# Other
LockedMessage = "Está bloqueado.",
DoesNotOpenFromThisSide="No se abre por este lado.",
OpenedDoorUsingKey="Abierto con [color=#77FFFF]%s[/color]", # FORMAT: Key name
SmokeDoorLockedMessage = "Una pared de humo caliente bloquea el camino.",
FunnyFeeling = "Tienes la sensación de que algo en el mundo ha cambiado...",
SmokeDoorConfirmation = "¿Consumir un Talismán de Humo para disipar el humo?",
LifeFragmentGet = "%s/4 [color=#ff4c42]FRAGMENTOS DE VIDA[/color]", # FORMAT: Number of life fragments
ConfirmationAnswers = ["Sí", "No"],
PlayerUpgradeOptions = {
	# FORMAT: Upgrade amount, cost.
	# Example: +10 Max LIFE - 10 pieces
	max_health = "[color=#ff4c42]+%s Max VIDA[/color] - %s piezas",
	max_energy = "[color=#baffcd]+%s Max ENERGÍA[/color] - %s piezas",
	max_water= "[color=#77FFFF]+%s Max AGUA[/color] - %s piezas",
	num_tool_slots = "+%s Espacio de Herramienta - %s piezas",
},

# boss kill messages
Victory = "VICTORIA",
AgelessSlain = "INTEMPORAL\nASESINADO",
UsurperSlain = "USURPADOR\nASESINADO",
AmtarrKill = "DIVINIDAD\nUSURPADA",

UpgradeToolSlot = "OBTENIDO\nESPACIO DE HERRAMIENTA",
UpgradeMaxWater = "MAX AGUA\nAUMENTADO",
UpgradeMaxEnergy = "MAX ENERGÍA\nAUMENTADA",
UpgradeMaxHealth = "MAX VIDA\nAUMENTADA",
FountainFound = "FUENTE\nLOCALIZADA",
WaterBuyMenuTitle = "COMPRAR [color=#77FFFF]AGUA[/color]",
WaterBuyMenuAmount = "CANTIDAD",
WaterBuyMenuCost = "COSTO",
Press = "Presiona",
GetUp = "para levantarte",
BuyWater = "para comprar [color=#77FFFF]AGUA",
CantAfford = "[color=#ff4c42]No tienes suficientes piezas.[/color]",
WaterFull = "[color=#77FFFF]AGUA[/color] [color=#ff4c42]ya está lleno.[/color]",
MapMarkers = "Marcadores del Mapa",
CaveSoundUneasyMessage = "Algo se siente raro...",
MessageNotAllowedHere = "No puedes dejar un mensaje aquí.",

AmtarrBlessingMessage = "BENDICIÓN DE\nAMTARR",
AmtarrBlessingToll = "[color=#ff4c42]La bendición de Amtarr tiene consecuencias dañinas...[/color]",
