# MASCOTAS
Items.ItemID.IMP_PET: {
	name = "Duende",
	description = "¡Es tu propio duende mascota!\n\n¡Gracias por apoyar el Kickstarter de FOUNTAINS!"
},
Items.ItemID.DOG_PET: {
	name = "Perro",
	description = "¡Es un perro mascota! Ve si sabe cómo traer."
},
Items.ItemID.CAT_PET: {
	name = "Gato",
	description = "¡Es un gato mascota! Los ratones le tienen miedo."
},
Items.ItemID.GOLDEN_GOLEM_PET: {
	name = "Golem Dorado",
	description = "¡Es tu golem mascota!\n\n¡Gracias por apoyar el Kickstarter de FOUNTAINS!"
},

},

# FLOOR MESSAGE TEXT
FloorMessageText = {
TEMPLATES = {
	blank_ahead = "%s adelante",
	blank_here = "%s aquí",
	no_blank_here = "no %s aquí",
	impending_blank = "inminente %s",
	blank_nearby = "%s cerca",
	beware_blank = "cuidado con %s",
	seek_blank = "busca %s",
	try_blank = "intenta %s",
	blank_required = "%s requerido",
	why_blank = "¿por qué %s?",
	blank = "%s",
	blank_question_mark = "%s?",
	is_this_blank_question_mark = "¿es esto %s?",
	sweet_blank = "dulce %s",
	accursed_blank = "maldito %s",
	blank_exclamation_mark = "%s!",
	blank_dot_dot_dot = "%s...",
	probably_blank = "probablemente %s",
	not_blank = "no %s",
	i_am_blank = "yo soy %s",
	when_in_doubt_blank = "cuando tengas dudas, %s",
},

JOINING_WORDS = {
	therefore = "\nde ahí que ",
	but = "\npero ",
	when = "\ncuando ",
	so = "\npor lo tanto ",
	in_other_words = "\nen otras palabras,\n",
	then = "\nentonces ",
	comma = ",\n",
	period = ".\n",
	dot_dot_dot = "...\n",
},

WORDS = {
	objects = {
		_label = "objetos",
		lantern = "linterna",
		candle = "vela",
		fountain = "fuente",
		trap = "trampa",
		book = "libro",
		chest = "cofre",
		smoke = "humo",
		charm = "talisman",
		coin = "moneda",
		wall = "pared",
		"floor": "suelo",
		skeleton = "esqueleto",
		door = "puerta",
		entrance = "entrada",
		banner = "bandera",
		exit = "salida",
		pillar = "pilar",
		mechanism = "mecanismo",
		statue = "estatua",
		hole = "agujero",
		cliff = "acantilado",
		automatic_door = "puerta automática",
		bridge = "puente",
		tree = "árbol",
		hook = "gancho",
		wood = "madera",
		sword = "espada",
		dirt = "tierra",
		stairs = "escaleras",
		headwear = "cabeza",
		chestplate = "pechera",
		shirt = "camisa",
		boots = "botas",
		pants = "pantalones",
		"tool": "herramienta",
		mushroom = "hongo",
		drink = "bebida",
		meal = "comida",
		fish = "pez",
		flower = "flor",
		ring = "anillo",
		spell = "hechizo",
		water = "AGUA",
		weapon = "arma",
		treasure = "tesoro",
		container = "contenedor",
		key = "clave",
		lock = "cerradura",
		pile = "montón",
		spear = "lanza",
		chair = "silla",
		table = "mesa",
		plant = "planta",
		stone = "piedra",
		fire = "fuego",
		ice = "hielo",
		spice = "especia",
		bomb = "bomba",
		map = "mapa",
		illusion = "ilusión",
		something = "algo",
		rope = "cuerda",
	},
	creatures = {
		_label = "criaturas",
		enemy = "enemigo",
		pet = "mascota",
		powerful_enemy = "enemigo poderoso",
		yak = "yak",
		animal = "animal",
		dog = "perro",
		cat = "gato",
		boar = "jabalí",
		frog = "rana",
		livestock = "ganado",
		bird = "pájaro",
		amphibian = "anfibio",
		lizard = "lagarto",
		horrible_sort = "tipo horrible",
		creature = "criatura",
		fish = "pez",
		bug = "bicho",
		abomination = "abominación",
		undead = "no muerto",
		sloth = "pereza",
		ogre = "ogro",
	},